11
+--+--+--+--+--+--+--+--+--+--+--+
   |        |              |     |
+  +  +--+  +  +--+--+  +--+  +  +
|  |  |        |     |     |  |  |
+  +  +--+--+--+  +--+--+--+--+  +
|        |  |  |           |     |
+--+  +  +  +  +--+--+  +--+--+  +
|  |  |           |  |           |
+  +--+--+  +--+--+  +  +  +--+  +
|     |           |  |  |     |  |
+--+  +  +  +--+  +  +  +--+  +--+
|     |  |  |              |     |
+--+  +--+--+  +--+--+  +  +--+  +
|     |     |  |     |  |  |  |  |
+  +--+  +--+  +--+  +  +--+  +  +
|     |        |              |  |
+  +  +--+  +--+--+--+--+  +--+  +
|  |     |        |        |     |
+  +--+--+  +--+--+--+--+--+--+  +
|        |              |     |  |
+--+  +  +--+  +--+--+  +  +  +  +
|     |              |  |  |      
+--+--+--+--+--+--+--+--+--+--+--+